NO textures/stock_wall.png
EA textures/red_brick.xpm42
SO textures/goose.png
WE textures/red_brick.xpm42
GO textures/goose.png
DC textures/door_close.png
DO textures/door_open.png
C 23,54,4
F 255,234,233

11111111111111111111111111111111111111111111111111
1W000000000000000000000000000000000000000000000001
1011111111111111111111111111111111111111111111101
1000000000000000000000000000000000000000000000001
1000000000111111111111111111111111111000000000001
1000000000100000000000000000000000010000000000001
1000000000101111111111111111111100011111111000001
1000000000101000000000000000000100000000010000001
1000000000101011111111111111110101111111011111101
1000000000101010000000000000010101000000000000011
1000000000101010111111111111010101011111111111011
1000000000101010100000000000010101000000000000011
1000000000101010101111111111110101111111111111011
1000000000101010101000000000010101000000000000011
1000000000101010101011111111010101011111111111011
1000000000101010101010000000010101000000000000011
1000000000101010101010111111110101111111111111011
1000000000101010101010100000000100000000000000011
1000000000101010101010101111111111111111111111011
1000000000101010101010101000000000000000000000011
1000000000101010101010101011111111111111111111011
1000000000101000000000000000000000000000000000011
1000000000101111111111111111111111111111111111011
1000000000100000000000000000000000000000000000011
1011111111111111111111111111111111111111111111D01
1D000000000000000000000000000000000000000000000001
11111111111111111111111111111111111111111111111111
