NO textures/stock_wall.png
EA textures/red_brick.xpm42
SO textures/goose.png
WE textures/red_brick.xpm42
GO textures/goose.png
DC textures/door_close.png
DO textures/door_open.png
C 23,54,4
F 255,234,233

111111111111111111111111111111
1W0000000000000000000000000011
101111111111111111011111111101
100000000000000000010000000001
100011111111111110010111111101
100010000000000010010100000001
100010111111111010010101111101
100010100000001010010100000001
100010101111101010010101111101
100010101000101010010100000001
100010101010101010010101111101
1000001010101010100101000000D1
101111101010101011110111111111
100000001000001000000000000001
1D1111111111111111111111111101
100000000000000000000000000001
101111111111111111111111111101
111111111111111111111111111111
