NO textures/stock_wall.png
EA textures/red_brick.xpm42
SO textures/goose.png
WE textures/red_brick.xpm42
GO textures/goose.png
DC textures/door_close.png
DO textures/door_open.png
C 23,54,4
F 255,234,233

1111111111111
1W000000000D1
1110111111101
1000100000101
1D00111110011
1111111111111
