NO textures/stock_wall.png
EA textures/red_brick.xpm42
SO textures/goose.png
WE textures/red_brick.xpm42
GO textures/goose.png
DC textures/door_close.png
DO textures/door_open.png
C 23,54,4
F 255,234,233

111111111111111
1W0000000000011
101111011111101
100001000000001
100001011110001
100001000010001
100111000010D01
100000000000001
1D1111111111101
111111111111111
