NO abc
EA spaten.txt
SO def
WE RTfj

C 23,54,4
F 255,234,233

1111111
1000001
10S0001
10000N1
1000001
1000001
1000001
1111111
