NO abc
EA spaten.txt
SO def
WE RTfj

C 23,54,4
F 255,234,233

1111111
1010001
1010111
10000N1
1110111
  10001
1110101
1111111
