NO red_brick.xpm
EA red_brick.xpm
SO red_brick.xpm
WE red_brick.xpm

C 23,54,4
F 255,234,233

1111111
1010001
10101111111111111111111
100000000000000000000W1
11101111111111111111111
  10001
1110101
1111111
