NO textures/plain_wall.png
EA textures/red_brick.xpm42
SO textures/red_brick.xpm42
WE textures/red_brick.xpm42

C 23,54,4
F 255,234,233

1111111
1010001
10101111111111111111111
100000000000000000000W1
111D1111111111111111111
  10001
1110101
1111111
